8, 6
0, 4
X X X 0 0 X
X X 0 0 0 X
X X 0 X 0 X
X X 0 X 0 P
0 0 0 0 0 X
0 X X X 0 D
0 X X X 0 X
G X X X X X
