7, 5
0, 4
X X 0 0 0 
X X D X 0 
X X 0 X 0 
X X X X 0 
0 0 0 0 0 
P X G X X 
0 X X X X 
