7, 5
1, 3
X X X 0 0
X X 0 0 0
X X 0 X 0
X X 0 X 0
0 0 0 P 0
0 X X X X
T X X X X